SO ./tex/bark.xpm
NO ./tex/bricks.xpm
EA ./tex/error.xpm
WE ./tex/wall.xpm

C 255,200,50
F 10,10,10

11111111111111111
10000000000000001
10000000000000001
10000000000000001
10000000000000001
10000000000000001
1000000000W000001
10000000000000001
10000000000000001
10000000000000001
10000000000000001
10000000000000001
11111111111111111