SO ./tex/bark.xpm
NO ./tex/bricks.xpm
EA ./tex/crackover.xpm
WE ./tex/wall.xpm

F 000,100,0
C 0,0,100

111111111111111111111111111111111111111111111111111111111111
1E0000000000000000000000000000011111111111111111111110000001
1110000000000000000000000000000000011111111111100000000000001
11110000000000000000000000000000000000011111111101111110111111
1111111111101111100111111111111111111111100111110111111011111
1111111111101111100111111111111111111111001111110111111011111
11111111111011111001111111111111000000000001111101111110111111
1111111111100000000111111111111100111001111111110111111011111111
11111111111011111001111111111100001110011111111101111110111111
111111111110111110000000000000011111110000000000000000101111111
1111111111111111111111111111111111111111111111111111111011111
1111111111111111111111111111111111111111111111111111111011111
1111111111111111111                 11111111100000000000001111
1111111111111111111111111111111111111111111111111111111010111
1111111111111111111111111111111111111111111111111111111010111
1111110000000000000000000000000000000000000000000011111010111
1111110000000000000000000000000000000000000000000011111010111
1111110000000000000000000000000000000000000000000011111010111
1111110000000000000000000000000000000000000000000011111010111
1111110000000000000000000000000000000000000000000011111010111
1111110000000000000000000000000000000000000000000011111010111
1111110000000000000000000000000000000000000000000011111010111
1111110000000000000000000000000000000000000000000011111010111
1111110000000000000000000000000000000000000000000011111010111
1111110000000000000000000000000000000000000000000011111010111
1111110000000000000000000000000000000000000000000000000000111
1111110000000000000000000000000000000000000000000011111110111
1111111111111111111111111111111111111111111111111111111111111
1111111111111111111111111111111111111111111111111111111111111
1111111111111111111111111111111111111111111111111111111111111